8 8
0 0
31 2 1 2 1 2 1 31 
31 5 4 7 6 3 2 31
31 4 2 1 3 4 5 31
31 7 31 7 31 7 31 31
31 31 31 31 31 31 31 31
31 2 7 3 6 2 7 31
9 10 9 10 10 9 10 9
31 31 31 31 31 31 31 31


